111111111111111111111111
100000000001000000000001
10000000111100P001000111
110000000000000010000001
100010011111000000111111
100010010001000000000001
100010000001000000000001
111111111111111111111111