NO  ./wall.png
SO  ./wall2.png
WE ./wall3s.png
EA ./wall4.png

F 223,1,1
C 223,1,1

1111111111111111111111111111111111
1000000000000000000000000000000001 1
100011110000000000N000000000000001
1111111111111111111111111111111111