NO  ./wall.png
SO  ./wall2.png
WE ./wall3.png
EA ./wall4.png

F 228,220,183
C 135,206,235

1111111111111111111111111111111111 1
1000000000N00000000000000000000001
1000111100000000000000000000000001
1111111111111111111111111111111111