NO  ./wall.png
SO  ./wall2.png
WE ./wall3.png
EA ./wall4.png

F 228,220,183
C 135,206,235

1111111111111111111111111111111111
1000000000000000000000000000000001 1
10001111000000000000000000000000N1
1111111111111111111111111111111111