11111111111111111111111111111111
10000000000100000000000000000001
10000000111100P00100011111111101
11000000000000001000000000000001
10001001111100000010000000010001
10001001000100000000000000100001
10001000000100000000000111111111
11111111111111111111111111111111