NO  ./wall.png
SO  ./wall2.png
WE ./wall3.png
EA ./wall4.png

F 223,1,1
C 223,1,1

1111111111111111111111111111111111
1000000000N00000000000000000000001
1000111100000000000000000000000001
1111111111111111111111111111111111